20 20
80 80 80
128 128 128
80 80 80
2 2 2 2 2 3 2 5 5 5 5 5 5 2 2 2 2 2 3 2
2 0 0 0 0 0 2 5 0 0 0 0 5 2 0 0 0 2 0 2
2 0 2 0 2 2 2 5 0 0 0 0 0 0 0 0 0 0 0 2
2 0 2 0 2 3 2 5 0 0 0 0 0 0 0 2 0 0 0 2
2 0 2 1 2 0 2 5 0 0 0 0 5 2 0 2 0 2 0 3
2 0 2 2 2 0 2 5 0 0 0 0 5 2 2 2 0 2 2 2
2 0 0 0 0 0 0 0 0 0 0 0 5 2 0 0 0 0 0 2
2 0 0 0 0 0 0 0 0 0 0 0 5 2 2 2 2 2 0 2
2 0 2 2 2 0 2 5 0 0 0 0 5 2 0 0 0 2 2 2
2 0 2 0 2 0 2 5 0 0 0 0 5 2 2 2 0 0 0 2
2 0 2 0 0 0 3 5 0 0 0 0 0 0 0 0 0 2 0 2
2 0 2 2 2 2 2 5 0 0 0 0 0 0 0 0 0 2 0 2
3 0 0 0 0 0 2 5 0 0 0 0 5 2 2 2 0 2 2 2
2 2 2 0 2 0 2 5 5 5 5 5 5 2 0 0 0 0 0 2
2 0 0 0 2 2 2 2 2 2 2 2 2 2 0 2 2 2 0 2
2 0 2 2 2 0 4 0 0 3 2 2 0 0 0 2 0 0 0 2
2 0 0 0 2 0 2 0 0 3 2 0 0 2 2 2 0 2 0 2
2 2 2 0 2 0 2 3 3 2 2 0 2 2 3 2 0 2 0 2
3 0 0 0 0 0 2 2 2 2 2 0 0 0 0 0 0 2 0 2
2 2 2 2 2 2 2 2 2 2 2 2 2 2 2 2 2 2 2 2